1111111111111
10010000P0PC1
1000011111001
100011E0C0001
1111111111111