1111111111111111111111
1C001C00000C000000C1C1
1000100000000011111101
111C1000000C0000000001
1110000011111111111101
1C1C1000000000001011C1
1C001111111000101011C1
1000000C000P0010100001
10000000001110001C0001
1000001111100011111001
100000100E100C00001011
1011001000111111001001
10C1000000000000001001
10C110000C111111C01C11
1111111111111111111111