1111111111111111111111
1C001C00000C000000C1C1
1111111101111111111111
1111111101111111111111
1111111100111111111111
1111111101111111111111
1111111101111111111111
1C001C00000C000000C1C1
1111111101111111111111
1C001C00000C000000C1C1
1C001C00000C000000C1C1
1111111111101111000011
1000000C000P0010100001
100000100E100C00001001
1111111111111111111111