11111111111111
1010CCCCCC0101
10CCCCCCCC1001
100CCCCPCCCC01
101CCCCCCCC001
1010CCCCCC1101
101000CC00E001
11111111111111