11111111111111111111
1CCCCCCCCCCCCCCCCCC1
1CCCCCCCCCCCCCCCCCC1
1CCCCCCCCCCCCCCCCCC1
1CCCCCCC000CCCCCCCC1
111111110P0111111111
1000000000000CC00001
10000C00000CCCCC0001
1000C00000CC000CC001
100C0C000000000CC001
10CCCCCC000000CC0001
10000C000000CC000001
10000C000CCCCCCC00E1
11111111111111111111