111111
10C001
10E001
100001
10P001
111111